~~~~~~~~~~~~
#<<<<<<<<D<<
___________^
S>>V_>>>>V_^
___L>R___L>^
S>>^_>V_>^__
______L>R___
S>>>>>^_>>>V
___________V
=========<<<